5 5 5 5 5 5 5 5 5 5 5 5 5 5 5 7 9 5 5 5 5 5 5 5 5 5 5 5 5 5 5 5 5 5 5 5 5 5 5 5 5 5 5 5 5 5 5 7 8 9 5 5 5 4 5 5 5 5 5 5
5 7 8 9 5 5 5 8 8 8 8 8 8 8 8 8 8 8 8 8 8 8 8 8 5 5 5 5 8 8 8 8 8 8 8 8 8 8 5 5 5 5 5 5 5 5 5 5 5 5 5 5 5 7 8 9 1 3 5 5
5 5 5 5 5 8 8 9 0 0 0 0 0 0 0 0 0 0 0 0 0 0 0 0 4 1 3 2 0 0 0 0 0 0 0 0 0 0 7 8 8 8 8 8 8 8 8 9 5 5 5 5 5 5 5 5 7 9 6 5
8 8 8 8 8 8 9 0 0 0 0 0 0 0 0 0 0 0 0 0 0 0 0 0 4 7 9 6 0 0 0 0 0 0 0 0 0 0 0 0 0 0 0 0 0 0 0 7 8 8 8 8 5 5 5 5 7 8 9 5
0 0 0 0 0 0 0 0 0 0 0 0 0 0 0 0 0 0 0 0 0 0 0 0 7 5 6 9 0 0 0 0 0 0 0 0 0 0 0 0 0 0 0 0 0 0 0 0 0 0 0 7 8 8 5 5 5 5 5 5
0 0 0 0 0 0 0 0 0 0 0 0 0 0 0 0 0 0 0 0 0 0 0 0 0 3 6 0 0 0 0 0 0 0 0 0 0 0 0 0 0 0 0 0 0 0 0 0 0 0 0 0 0 0 7 8 8 5 5 5
0 0 0 0 0 0 0 0 0 1 2 2 2 0 0 0 0 0 0 0 0 0 0 0 0 4 6 0 0 0 0 0 0 0 0 0 0 0 0 0 0 0 0 0 0 0 0 0 0 0 0 0 0 0 0 0 7 8 8 8
0 0 0 0 0 0 0 0 1 4 7 9 6 1 2 3 0 0 0 0 0 0 0 0 0 7 9 0 0 0 0 0 0 0 0 1 3 0 1 3 0 0 1 2 2 3 0 0 0 0 0 0 0 0 0 0 0 0 0 0
0 0 0 0 0 0 0 0 4 5 8 8 8 8 8 9 0 0 0 0 0 0 0 0 0 0 0 0 0 0 0 0 0 0 0 4 5 2 5 6 0 0 7 4 5 2 0 0 0 0 0 0 0 0 0 0 0 0 0 0
0 0 0 0 0 0 0 0 4 6 0 0 0 0 0 0 0 0 0 0 0 0 0 0 0 0 0 0 0 0 0 0 0 1 2 1 3 5 5 6 0 0 0 7 4 5 3 0 0 0 0 0 0 0 0 0 0 0 0 0
0 0 0 0 0 1 2 2 8 9 0 0 0 0 0 0 0 0 0 0 0 0 0 0 0 0 0 0 0 0 1 2 3 2 5 7 9 5 5 9 0 0 0 0 7 4 5 3 0 0 0 0 0 0 0 0 0 0 0 0
0 0 0 0 0 4 5 5 6 0 0 0 0 0 0 0 0 0 0 0 0 0 0 0 0 0 0 0 0 0 4 5 6 8 8 4 6 8 9 0 0 0 0 0 0 7 4 5 3 0 0 0 0 0 0 0 0 0 0 0
0 0 0 0 0 7 8 9 2 5 5 6 9 0 0 0 0 0 0 0 0 0 0 0 0 0 0 0 0 0 7 8 9 0 0 4 6 0 0 0 0 0 0 0 0 0 7 5 2 2 2 2 3 0 0 0 0 0 0 0
0 0 0 0 0 0 0 0 7 8 8 9 0 0 0 0 0 0 0 0 0 0 0 0 0 0 0 0 0 0 0 0 0 0 0 7 9 0 0 0 0 0 0 0 0 0 0 2 5 1 3 5 6 0 0 0 0 0 0 0
0 0 0 0 0 0 0 0 0 0 0 0 0 0 0 0 0 0 0 0 0 0 0 0 0 0 0 0 0 0 0 0 0 0 0 0 0 0 0 0 0 0 0 0 0 0 2 3 5 7 9 5 6 0 0 0 0 0 0 0
0 0 0 0 0 0 0 0 0 0 0 0 0 0 0 0 0 0 0 0 1 2 3 0 0 0 0 0 0 0 0 0 0 0 0 0 0 0 0 0 0 0 0 0 0 2 2 5 5 5 5 5 6 0 0 0 0 0 0 0
0 0 0 0 0 0 0 0 0 0 0 0 0 0 0 1 2 5 4 2 4 5 6 1 2 2 2 2 3 0 0 0 0 0 0 0 0 0 0 0 0 0 0 0 0 2 5 5 8 8 8 8 9 0 0 0 0 0 0 0
0 0 0 0 0 0 0 0 0 0 0 0 1 2 2 2 5 5 5 5 5 1 3 4 5 5 5 5 5 5 2 3 0 0 0 0 0 0 0 0 0 0 0 1 2 5 5 6 0 0 0 0 0 0 0 0 0 0 0 0
2 3 0 0 1 2 2 2 2 2 2 2 2 5 5 7 8 8 9 5 5 7 9 5 5 5 5 5 5 5 5 5 5 2 3 0 0 0 0 0 0 0 0 4 5 5 6 9 0 0 0 0 0 0 0 0 0 0 0 0
5 5 2 2 7 5 5 5 5 5 5 5 5 5 5 5 5 5 5 5 5 5 5 5 5 5 5 5 5 5 5 5 5 5 6 0 0 0 0 0 0 0 0 4 5 5 6 0 0 0 0 0 0 0 0 0 0 0 0 0