06, 06, 06, 06, 06, 06, 06, 06, 06, 06, 06, 06, 06, 06, 06, 06, 06, 06, 06, 06, 06, 06, 06, 06, 06, 06, 06, 06, 06, 06
06, 06, 06, 06, 06, 06, 06, 06, 06, 06, 06, 06, 06, 06, 06, 06, 06, 06, 06, 06, 06, 06, 06, 06, 06, 06, 06, 06, 06, 06
06, 06, 06, 06, 06, 06, 06, 06, 06, 06, 06, 06, 06, 06, 06, 06, 06, 06, 06, 06, 06, 06, 06, 06, 06, 06, 06, 06, 06, 06
06, 06, 06, 06, 06, 06, 06, 06, 06, 06, 06, 06, 06, 06, 10, 06, 06, 06, 06, 06, 06, 06, 06, 06, 06, 06, 06, 06, 06, 06
06, 06, 06, 06, 06, 06, 06, 06, 06, 06, 06, 06, 06, 06, 14, 06, 06, 06, 06, 06, 06, 06, 06, 06, 06, 06, 06, 06, 06, 06
06, 06, 06, 06, 06, 06, 20, 06, 07, 06, 06, 06, 06, 06, 06, 06, 06, 06, 06, 06, 06, 06, 06, 06, 06, 06, 06, 06, 06, 06
06, 06, 06, 06, 06, 06, 21, 06, 11, 06, 06, 06, 06, 03, 04, 15, 06, 06, 06, 06, 06, 06, 06, 06, 06, 06, 06, 06, 06, 06
06, 06, 06, 06, 06, 06, 06, 06, 06, 06, 06, 06, 06, 06, 06, 06, 06, 06, 06, 06, 06, 06, 06, 06, 06, 06, 06, 06, 06, 06
06, 06, 06, 06, 06, 06, 06, 06, 06, 06, 06, 06, 18, 19, 06, 06, 06, 06, 06, 06, 06, 06, 06, 06, 06, 06, 06, 06, 06, 06
06, 06, 06, 06, 06, 06, 06, 06, 06, 06, 06, 06, 06, 06, 06, 06, 06, 19, 19, 19, 06, 06, 06, 06, 06, 06, 06, 06, 06, 06
06, 06, 06, 06, 06, 06, 06, 06, 06, 06, 06, 06, 0, 06, 06, 06, 06, 19, 106, 19, 06, 06, 06, 06, 06, 06, 06, 06, 06, 06
06, 06, 06, 06, 06, 06, 06, 06, 06, 09, 06, 06, 06, 06, 06, 06, 06, 19, 19, 19, 06, 06, 06, 06, 06, 06, 06, 06, 06, 06
06, 06, 06, 06, 06, 06, 06, 06, 08, 13, 06, 06, 06, 06, 06, 06, 06, 06, 06, 06, 06, 06, 06, 06, 06, 06, 06, 06, 06, 06
06, 06, 06, 06, 06, 06, 06, 15, 12, 19, 06, 06, 18, 06, 06, 06, 06, 06, 06, 06, 06, 06, 06, 06, 06, 06, 06, 06, 06, 06
06, 06, 06, 06, 06, 06, 06, 06, 06, 06, 06, 06, 06, 06, 06, 06, 06, 06, 06, 06, 06, 06, 06, 06, 06, 06, 06, 06, 06, 06
06, 06, 06, 06, 06, 06, 06, 06, 06, 06, 06, 06, 06, 06, 06, 06, 06, 06, 06, 06, 06, 06, 06, 06, 06, 06, 06, 06, 06, 06
06, 06, 06, 06, 06, 06, 06, 06, 06, 06, 06, 06, 06, 06, 06, 06, 06, 06, 06, 06, 06, 06, 06, 06, 06, 06, 06, 06, 06, 06
06, 06, 06, 06, 06, 06, 06, 06, 06, 06, 06, 06, 06, 06, 06, 06, 06, 06, 06, 06, 06, 06, 06, 06, 06, 06, 06, 06, 06, 06
06, 06, 06, 06, 06, 06, 06, 06, 06, 06, 06, 06, 06, 06, 06, 06, 06, 06, 06, 06, 06, 06, 06, 06, 06, 06, 06, 06, 06, 06
06, 06, 06, 06, 06, 06, 06, 06, 06, 06, 06, 06, 06, 06, 06, 06, 06, 06, 06, 06, 06, 06, 06, 06, 06, 06, 06, 06, 06, 06


0, 0, 0, 0, 0, 0, 0, 0, 0, 0, 0, 0, 0, 0, 0, 0, 0, 0, 0, 0, 0, 0, 0, 0, 0, 0, 0, 0, 0, 0
0, 0, 0, 0, 0, 0, 0, 0, 0, 0, 0, 0, 0, 0, 0, 0, 0, 0, 0, 0, 0, 0, 0, 0, 0, 0, 0, 0, 0, 0
0, 0, 0, 0, 0, 0, 0, 0, 0, 0, 0, 0, 0, 0, 0, 0, 0, 0, 0, 0, 0, 0, 0, 0, 0, 0, 0, 0, 0, 0
0, 0, 0, 0, 0, 0, 0, 0, 0, 0, 0, 0, 0, 0, 1, 0, 0, 0, 0, 0, 0, 0, 0, 0, 0, 0, 0, 0, 0, 0
0, 0, 0, 0, 0, 0, 0, 0, 0, 0, 0, 0, 0, 0, 1, 0, 0, 0, 0, 0, 0, 0, 0, 0, 0, 0, 0, 0, 0, 0
0, 0, 0, 0, 0, 0, 1, 0, 1, 0, 0, 0, 0, 0, 0, 0, 0, 0, 0, 0, 0, 0, 0, 0, 0, 0, 0, 0, 0, 0
0, 0, 0, 0, 0, 0, 1, 0, 1, 0, 0, 0, 0, 1, 1, 1, 0, 0, 0, 0, 0, 0, 0, 0, 0, 0, 0, 0, 0, 0
0, 0, 0, 0, 0, 0, 0, 0, 0, 0, 0, 0, 0, 0, 0, 0, 0, 0, 0, 0, 0, 0, 0, 0, 0, 0, 0, 0, 0, 0
0, 0, 0, 0, 0, 0, 0, 0, 0, 0, 0, 0, 1, 1, 0, 0, 0, 0, 0, 0, 0, 0, 0, 0, 0, 0, 0, 0, 0, 0
0, 0, 0, 0, 0, 0, 0, 0, 0, 0, 0, 0, 0, 0, 0, 0, 0, 1, 1, 1, 0, 0, 0, 0, 0, 0, 0, 0, 0, 0
0, 0, 0, 0, 0, 0, 0, 0, 0, 0, 0, 0, 0, 0, 0, 0, 0, 1, 1, 1, 0, 0, 0, 0, 0, 0, 0, 0, 0, 0
0, 0, 0, 0, 0, 0, 0, 0, 0, 1, 0, 0, 0, 0, 0, 0, 0, 1, 1, 1, 0, 0, 0, 0, 0, 0, 0, 0, 0, 0
0, 0, 0, 0, 0, 0, 0, 0, 1, 1, 0, 0, 0, 0, 0, 0, 0, 0, 0, 0, 0, 0, 0, 0, 0, 0, 0, 0, 0, 0
0, 0, 0, 0, 0, 0, 0, 1, 1, 1, 0, 0, 1, 0, 0, 0, 0, 0, 0, 0, 0, 0, 0, 0, 0, 0, 0, 0, 0, 0
0, 0, 0, 0, 0, 0, 0, 0, 0, 0, 0, 0, 0, 0, 0, 0, 0, 0, 0, 0, 0, 0, 0, 0, 0, 0, 0, 0, 0, 0
0, 0, 0, 0, 0, 0, 0, 0, 0, 0, 0, 0, 0, 0, 0, 0, 0, 0, 0, 0, 0, 0, 0, 0, 0, 0, 0, 0, 0, 0
0, 0, 0, 0, 0, 0, 0, 0, 0, 0, 0, 0, 0, 0, 0, 0, 0, 0, 0, 0, 0, 0, 0, 0, 0, 0, 0, 0, 0, 0
0, 0, 0, 0, 0, 0, 0, 0, 0, 0, 0, 0, 0, 0, 0, 0, 0, 0, 0, 0, 0, 0, 0, 0, 0, 0, 0, 0, 0, 0
0, 0, 0, 0, 0, 0, 0, 0, 0, 0, 0, 0, 0, 0, 0, 0, 0, 0, 0, 0, 0, 0, 0, 0, 0, 0, 0, 0, 0, 0
0, 0, 0, 0, 0, 0, 0, 0, 0, 0, 0, 0, 0, 0, 0, 0, 0, 0, 0, 0, 0, 0, 0, 0, 0, 0, 0, 0, 0, 0
